F 250,230,21
C 31,69,58

SO                              ./textures/greystone.xpm
NO   ./textures/colorstone.xpm

EA ./textures/wood.xpm
WE  ./textures/redbrick.xpm




        1111111111111111111111111
        1000000000110000000000001
        1011000001110000000000001
        1001000100000000000000001
111111111011111111110000000000001
10000000001        11000001110111111111111
1111011111111111111100001000111
11110111111111011101S00010001
11000000110101011100000010001
10000000000000001100000010001
10000000000000001100010010001
11000001110101011111011110011
11110111 1110101 101111010001
11111111 1111111 111111111111