NO ./textures/colorstone.xpm

EA ./textures/wood.xpm

SO ./textures/greystone.xpm


        WE ./textures/redbrick.xpm


F 184,13,1
C 51,198,227

11111111
100000011
1W00000011
1111111111